╔═══════════════════╦═══════════════════╗
║█                 █║█                 █║
║█ █╔═╗█ █╔═════╗█ █║█ █╔═════╗█ █╔═╗█ █║
║█ █╚═╝█ █╚═════╝█ █╨█ █╚═════╝█ █╚═╝█ █║
║█                                     █║
║█ █═══█ █╥█  ══════╦══════█ █╥█ █═══█ █║
║█       █║█       █║█       █║█       █║
╚═════╗█ █╠══════█ █╨█ █══════╣█ █╔═════╝
      ║█ █║█                 █║█ █║      
══════╝█ █╨█ █╔════---════╗█ █╨█ █╚══════
   <    ∘    █║      þ    ║█             
══════╗█ █╥█ █║  ß        ║█ █╥█ █╔══════
      ║█ █║█ █╚═══════════╝█ █║█ █║      
      ║█ █║█                 █║█ █║      
╔═════╝█ █╨█ █══════╦══════█ █╨█ █╚═════╗
║█                 █║█                 █║
║█ █══╗█ █═══════█ █╨█ █═══════█ █╔══█ █║
║█   █║█                         █║█   █║
╠══█ █╨█ █╥█ █══════╦══════█ █╥█ █╨█ █══╣
║█       █║█       █║█       █║█       █║
║█ █══════╩══════█ █╨█ █══════╩══════█ █║
║█                                     █║
╚═══════════════════════════════════════╝