╔═══════╦═══════════════════════╦═══════╗
║█∘ ∘ ∘█║█∘ ∘ ∘ ∘ ∘ ∘ ∘ ∘ ∘ ∘ ∘█║█∘ ∘ ∘█║
║█∘█║█∘█╨█∘█╥█∘█════╦════█∘█╥█∘█╨█∘█║█∘█║
║█+█║█∘ ∘ ∘█║█∘ ∘ ∘█╨█∘ ∘ ∘█║█∘ ∘ ∘█║█+█║
╠═══╣█∘█════╬════█∘█╬█∘ ════╬════ ∘█╠═══╣
║█∘█║█∘ ∘ ∘█║█∘ ∘ ∘ ∘ ∘ ∘ ∘█║█∘ ∘ ∘█║█∘█║
║█∘█║█∘█╬█∘█╨█∘█╬█∘█╥█∘█╬█∘█╨█∘█╬█∘█║█∘█║
║█∘ ∘ ∘ ∘ ∘ ∘ ∘ ∘ ∘█║█∘ ∘ ∘ ∘ ∘ ∘ ∘ ∘ ∘█║
║█∘█╥█∘█╥█∘█╥█ █╬═══╬═══╬█ █╥█∘█╥█∘█╥█∘█║
║█∘█║█∘█║█∘█║█             █║█∘█║█∘█║█∘█║ 
╝█∘█║█∘█║█∘█║█ █╔═-----═╗█ █║█∘█║█∘█║█∘█╚
 █+   ∘   ∘    █║  ß  ç ║█    ∘   ∘   +█  
╗█∘█║█∘█║█∘█║█ █║Ï   þ  ║█ █║█∘█║█∘█║█∘█╔
║█∘█║█∘█║█∘█╨█ █╚═══════╝█ █╨█∘█║█∘█║█∘█║
║█∘█║█∘█║█∘                   ∘█║█∘█║█∘█║
║█∘█╨█∘█╨█∘█╬═══════╦═══════╬█∘█╨█∘█╨█∘█║
║█∘ ∘ ∘ ∘ ∘ ∘ ∘ ∘ ∘█║█∘ ∘ ∘ ∘ ∘ ∘ ∘ ∘ ∘█║
║█∘█══╗█∘█═══════█∘█╨█∘█═══════█∘█╔══█∘█║
║█+ ∘█║█∘ ∘ ∘ ∘ ∘ ∘ ∘ ∘ ∘ ∘ ∘ ∘ ∘█║█∘ +█║
╠══ ∘█╨█∘█╥█∘█══════╦══════█∘█╥█∘█╨█∘█══╣
║█∘ ∘ ∘ ∘█║█∘ ∘ ∘ ∘█║█∘ ∘ ∘ ∘ ║█∘ ∘ ∘ ∘█║
║█∘█══════╩══════█∘█╨█∘█══════╩══════█∘█║
║█< ∘ ∘ ∘ ∘ ∘ ∘ ∘ ∘ ∘ ∘ ∘ ∘ ∘ ∘ ∘ ∘ ∘ ∘█║
╚═══════════════════════════════════════╝
