╔═══════╦═══════════════════════╦═══════╗
║█∘ ∘ ∘█║█∘ ∘ ∘ ∘ ∘ ∘ ∘ ∘ ∘ ∘ ∘█║█∘ ∘ ∘█║
║█∘█║█∘█╨█∘█╥█∘█════╦════█∘█╥█∘█╨█∘█║█∘█║
║█+█║█∘ ∘ ∘█║█∘ ∘ ∘█╨█∘ ∘ ∘█║█∘ ∘ ∘█║█+█║
╠═══╣█∘█════╬════█∘█╬█∘ ════╬════ ∘█╠═══╣
║█∘█║█∘ ∘ ∘█║█∘ ∘ ∘ ∘ ∘ ∘ ∘█║█∘ ∘ ∘█║█∘█║
║█∘█║█∘█╬█∘█╨█∘█╬█∘█╥ ∘ ╬ ∘█╨█∘█╬█∘█║█∘█║
║█∘ ∘ ∘ ∘ ∘ ∘ ∘ ∘ ∘█║ ∘ ∘ ∘ ∘ ∘ ∘ ∘ ∘ ∘█║
║█∘█╥█∘█╥█∘█╥█ █╬═══╬═══╬█ █╥█∘█╥█∘█╥█∘█║
║█∘█║█∘█║█∘█║█             █║█∘█║█∘█║█∘█║ 
║█∘█║█∘█║█∘█║█ █╔═-----═╗█ █║█∘█║█∘█║█∘█║
║█+█║█∘█║█∘█║█ █║  ß    ║█ █║█∘█║█∘█║█+█║ 
║█∘█║█∘█║█∘█║█ █║    þ  ║█ █║█∘█║█∘█║█∘█║
║█∘█║█∘█║█∘█╨█ █╚═══════╝█ █╨█∘█║█∘█║█∘█║
║█∘█║█∘█║█∘                   ∘█║█∘█║█∘█║
║█∘█╨█∘█╨█∘█╬═══════╦═══════╬█∘█╨█∘█╨█∘█║
║█∘ ∘ ∘ ∘ ∘ ∘ ∘ ∘ ∘█║█∘ ∘ ∘ ∘ ∘ ∘ ∘ ∘ ∘█║
║█∘█══╗█∘█═══════█∘█╨█∘█═══════█∘█╔══█∘█║
║█+ ∘█║█∘ ∘ ∘ ∘ ∘ ∘ ∘ ∘ ∘ ∘ ∘ ∘ ∘█║█∘ +█║
╠══ ∘█╨█∘█╥█∘█══════╦══════█∘█╥█∘█╨█∘█══╣
║█∘ ∘ ∘ ∘█║█∘ ∘ ∘ ∘█║█∘ ∘ ∘ ∘ ║█∘ ∘ ∘ ∘█║
║█∘█══════╩══════█∘█╨█∘█══════╩══════█∘█║
║█< ∘ ∘ ∘ ∘ ∘ ∘ ∘ ∘ ∘ ∘ ∘ ∘ ∘ ∘ ∘ ∘ ∘ ∘█║
╚═══════════════════════════════════════╝
